xxx\           
xxx|...........
xDx|...........
...............
...............
...............
