xxx\           
xxx|...........
xDx|...........
...............
...............
...............
111111111111111
1111...........
1D11...........
...............
...............
...............
